{
    "size" : [11,10],
    "luggage":
        [
            [5, 2, "A"],
            [3, 3, "B"],
            [5, 8, "C"]
        ],
    "map" : [
            ". . . . . . . . . .",
            ". . . . . . . A . .",
            ". . . . > > > ^ . .",
            ". . . . . . . ^ . .",
            ". . . ^ v < < ^ . .",
            "v > > ^ v . ^ < . .",
            "v . ^ < v . ^ . . .",
            "C > B ^ v . ^ . . .",
            ". v . ^ > > ^ . . .",
            ". v < < . . . . . .",
            ". . . . . . . . . ."
            ]
}
