10 10
. . . . . . . . . .
. . . . . . . . . .
. . . . > > > . . .
. . . . . . . . . .
. . . . v < < . . .
v < < . v . ^ . . .
v . ^ < v . ^ . . .
. . . . v . ^ . . .
. . v . > > ^ . . .
. . . . . . . . . .
3
5 1
3 3
5 7
