{
    "size" : [11,10],
    "luggage":
        [
            [5, 2],
            [3, 3],
            [5, 8]
        ],
    "map" : [
            ". . . . . . . . . .",
            ". . . . . . . . . .",
            ". . . . > > > ^ . .",
            ". . . . . . . ^ . .",
            ". . . ^ v < < ^ . .",
            "v > > ^ v . ^ < . .",
            "v . ^ < v . ^ . . .",
            ". > . ^ v . ^ . . .",
            ". v . ^ > > ^ . . .",
            ". v < < . . . . . .",
            ". . . . . . . . . ."
            ]
}
