5 5
. . . . .
v < < < ^
v . . . ^
> > > > ^
. . . . .
2
0 1
3 3
