5 5
. . . . A
v < < < ^
v . B . ^
> > > > ^
. . . . .
2
0 1 A
3 3 B
